%%%%%%%%%%%%%%%%%%%%
%    %  .     %    %
% %% % %%%%%% % %% %
% %.     .       % %
% % %% %%  %% %% % %
%      %.  .%      %
% % %% %%%%%% %% % %
% %       .  .   % %
% %% % %%%%%% % %% %
%    %   P .  %    %
%%%%%%%%%%%%%%%%%%%%
