%%%%%%%%%
%.P    .% 
% %.%.%%%  
%.    %%% 
%%%%%%%%%
