%%%%%%%%%%%%%%%%%%%%%%
% %%        % %      %
%    %%%%%% % %%%%%% %
%%%%%%     P  %      %
%    % %%%%%% %% %%%%%
% %%%% %    .    %   %
%    .   %%% %%%   % %
%%%%%%%%%%    %%%%%% %
%          %%       .%
%%%%%%%%%%%%%%%%%%%%%%
